11111111111111111111111111111
1CPE0001111111111111111111111
10000001111111111111111111111
11111111111111111111111111111
10000001111111111111111111111
11111111111111111111111111111
10000001111111111111111111111
11111111111111111111111111111
10000001111111111111111111111
11111111111111111111111111111
11111111111111111111111111111
11111111111111111111111111111