1111111111111111111111111111111111
1CPE0C0111111111111111111111111111
1000000111111111111111111111111111
1111111111111111111111111111111111
1000000111111111111111111111111111
1111111111111111111111111111111111
1000000111111111111111111111111111
1111111111111111111111111111111111
1000000111111111111111111111111111
1111111111111111111111111111111111
1000000111111111111111111111111111
1111111111111111111111111111111111
1111111111111111111111111111111111
1111111111111111111111111111111111
1111111111111111111111111111111111
1111111111111111111111111111111111
1111111111111111111111111111111111
1111111111111111111111111111111111
1111111111111111111111111111111111