1111111111
11C0000011
110P111111
100000E011
1111111111