11111111111111111
1PCCCCCCCCCCCCCE1
1CCCCCCCCCCCCCCC1
1CCCCCCCCCCCCCCC1
1CCCCCCCCCCCCCCC1
1CCCCCCCCCCCCCCC1
1CCCCCCCCCCCCCCC1
1CCCCCCCCCCCCCCC1
1CCCCCCCCCCCCCCC1
1CCCCCCCCCCCCCCC1
11111111111111111