111111111111
111111111111111
111PCCCECC11
1111111111111111