111111111111
110P00001111
11100000E0C1 
111111111111