111111111
11CCCC111
11P111111
1CCCCCE11
111111111