111111111111
1CPECCCCCCC1
1CCCCCCCCCC1
1CCCCCCCCCC1
1CCCCCCCCCC1
111111111111